ID;invariantType;classification;GPT_verdict;confidence;promptTokens;completionTokens;totalTokens;maxNumberOfOperations
0;daikon.inv.binary.twoString.StringEqual;FP;FP;0.7;722;508;1230;50
1;daikon.inv.binary.twoScalar.IntEqual;FP;FP;0.9;656;460;1116;10000
2;daikon.inv.binary.twoString.StringEqual;FP;TP;0.95;804;396;1200;10000
3;daikon.inv.binary.twoScalar.IntEqual;TP;TP;0.95;702;455;1157;10000
4;daikon.inv.binary.twoScalar.IntEqual;TP;TP;0.9;718;405;1123;10000
5;daikon.inv.binary.twoScalar.IntEqual;TP;TP;0.9;717;452;1169;10000
6;daikon.inv.binary.twoScalar.IntEqual;TP;TP;0.95;718;416;1134;10000
7;daikon.inv.binary.twoScalar.IntEqual;FP;FP;0.9;659;430;1089;100
8;daikon.inv.binary.twoScalar.IntEqual;FP;TP;0.9;666;398;1064;10000
9;daikon.inv.binary.twoScalar.IntEqual;FP;FP;0.7;666;449;1115;100
10;daikon.inv.unary.scalar.NonZero;TP;TP;0.95;599;418;1017;10000
11;daikon.inv.unary.string.OneOfString;TP;TP;0.85;697;402;1099;10000
12;daikon.inv.unary.string.OneOfString;TP;FP;0.8;677;466;1143;10000
13;daikon.inv.unary.scalar.LowerBound;TP;TP;0.95;657;384;1041;10000
14;daikon.inv.unary.scalar.LowerBound;TP;TP;0.95;670;385;1055;10000
15;daikon.inv.unary.scalar.LowerBound;TP;TP;0.95;647;343;990;10000
16;daikon.inv.unary.scalar.LowerBound;TP;TP;0.95;665;371;1036;10000
17;daikon.inv.unary.scalar.NonZero;TP;TP;0.95;602;392;994;10000
18;daikon.inv.unary.scalar.OneOfScalar;FP;FP;0.7;650;412;1062;10000
19;daikon.inv.unary.string.OneOfString;TP;TP;0.9;666;445;1111;10000
20;daikon.inv.unary.scalar.NonZero;TP;TP;0.95;593;435;1028;10000
21;daikon.inv.unary.scalar.OneOfScalar;TP;TP;0.85;663;426;1089;10000
22;daikon.inv.binary.twoScalar.IntLessThan;FP;TP;0.9;725;508;1233;10000
23;daikon.inv.binary.twoScalar.IntLessThan;FP;FP;0.8;728;531;1259;10000
24;daikon.inv.binary.twoScalar.IntNonEqual;FP;TP;0.9;717;538;1255;50
25;daikon.inv.binary.twoScalar.IntGreaterThan;FP;FP;0.9;784;465;1249;50
26;daikon.inv.binary.twoScalar.IntLessThan;FP;FP;0.8;718;445;1163;10000
27;daikon.inv.binary.twoScalar.IntLessThan;FP;TP;0.95;721;487;1208;10000
28;daikon.inv.binary.twoScalar.IntNonEqual;FP;TP;0.95;698;380;1078;10000
29;daikon.inv.binary.twoScalar.IntGreaterThan;FP;TP;0.75;710;410;1120;10000
30;daikon.inv.binary.twoScalar.IntGreaterThan;FP;TP;0.95;719;436;1155;10000
31;daikon.inv.binary.twoScalar.IntNonEqual;FP;TP;0.95;700;456;1156;10000
32;daikon.inv.binary.twoScalar.IntGreaterThan;FP;TP;0.95;718;487;1205;10000
33;daikon.inv.binary.twoScalar.IntGreaterThan;FP;TP;0.95;780;435;1215;10000
34;daikon.inv.binary.twoScalar.IntGreaterThan;FP;FP;0.7;714;435;1149;100
35;daikon.inv.binary.twoScalar.IntNonEqual;FP;TP;0.95;725;427;1152;10000
36;daikon.inv.binary.twoScalar.IntNonEqual;FP;TP;0.95;702;480;1182;10000
37;daikon.inv.binary.twoScalar.IntGreaterThan;FP;FP;0.7;721;474;1195;10000
38;daikon.inv.binary.twoScalar.IntGreaterThan;FP;FP;0.7;802;478;1280;10000
39;daikon.inv.binary.twoScalar.IntGreaterEqual;FP;TP;0.95;726;426;1152;50
40;daikon.inv.unary.scalar.NonZero;TP;TP;0.95;596;415;1011;10000
41;daikon.inv.unary.sequence.EltNonZero;TP;TP;0.95;606;421;1027;10000
42;daikon.inv.binary.twoScalar.IntGreaterEqual;TP;TP;0.95;626;473;1099;10000
43;daikon.inv.binary.twoScalar.IntNonEqual;FP;FP;0.9;623;501;1124;100
44;daikon.inv.binary.twoScalar.IntNonEqual;FP;FP;0.8;625;505;1130;50
45;daikon.inv.unary.string.IsUrl;TP;TP;0.95;741;411;1152;10000
46;daikon.inv.unary.string.FixedLengthString;TP;FP;0.8;672;469;1141;10000
47;daikon.inv.unary.string.IsUrl;TP;TP;0.95;700;372;1072;10000
48;daikon.inv.unary.string.IsUrl;TP;TP;0.95;692;334;1026;10000
49;daikon.inv.unary.string.IsUrl;TP;TP;0.95;747;447;1194;10000
50;daikon.inv.unary.string.IsUrl;TP;TP;0.95;766;439;1205;10000
51;daikon.inv.unary.string.IsUrl;TP;TP;0.95;753;415;1168;10000
52;daikon.inv.unary.string.IsUrl;TP;TP;0.95;768;404;1172;10000
53;daikon.inv.unary.string.IsUrl;TP;TP;0.95;740;409;1149;10000
54;daikon.inv.unary.string.IsUrl;TP;TP;0.95;739;410;1149;10000
55;daikon.inv.unary.string.IsUrl;TP;TP;0.95;730;392;1122;10000
56;daikon.inv.unary.string.IsUrl;TP;TP;0.95;723;385;1108;10000
57;daikon.inv.unary.string.IsUrl;TP;TP;0.95;752;408;1160;10000
58;daikon.inv.unary.string.FixedLengthString;TP;FP;0.9;651;441;1092;10000
59;daikon.inv.unary.string.IsUrl;TP;TP;0.95;702;341;1043;10000
60;daikon.inv.unary.string.IsUrl;TP;TP;0.95;708;414;1122;10000
61;daikon.inv.unary.string.IsUrl;TP;TP;0.95;756;417;1173;10000
62;daikon.inv.unary.string.IsUrl;TP;TP;0.95;768;419;1187;10000
63;daikon.inv.unary.string.IsUrl;TP;TP;0.95;757;430;1187;10000
64;daikon.inv.unary.string.IsUrl;TP;TP;0.95;751;391;1142;10000
65;daikon.inv.unary.string.IsUrl;TP;TP;0.95;787;320;1107;10000
66;daikon.inv.unary.string.IsUrl;TP;TP;0.95;745;423;1168;10000
67;daikon.inv.unary.string.IsUrl;TP;TP;0.95;755;406;1161;10000
68;daikon.inv.unary.string.IsUrl;TP;TP;0.95;769;344;1113;10000
69;daikon.inv.unary.string.IsUrl;TP;TP;0.95;753;381;1134;10000
70;daikon.inv.unary.string.IsUrl;TP;TP;0.95;735;385;1120;10000
71;daikon.inv.unary.string.IsUrl;TP;TP;0.95;748;396;1144;10000
72;daikon.inv.unary.string.IsUrl;TP;TP;0.95;742;414;1156;10000
73;daikon.inv.unary.string.IsUrl;TP;TP;0.95;736;419;1155;10000
74;daikon.inv.unary.string.IsUrl;TP;TP;0.95;740;380;1120;10000
75;daikon.inv.unary.string.IsUrl;TP;TP;0.99;768;398;1166;10000
76;daikon.inv.unary.string.IsUrl;TP;TP;0.95;755;354;1109;10000
77;daikon.inv.unary.string.IsUrl;TP;TP;0.95;763;447;1210;10000
78;daikon.inv.unary.string.IsUrl;TP;TP;0.95;752;359;1111;10000
79;daikon.inv.unary.string.IsUrl;TP;TP;0.95;758;383;1141;10000
80;daikon.inv.unary.string.IsUrl;TP;TP;0.95;758;448;1206;10000
81;daikon.inv.unary.string.IsUrl;TP;TP;0.95;773;392;1165;10000
82;daikon.inv.unary.string.IsUrl;TP;TP;0.95;740;398;1138;10000
83;daikon.inv.unary.string.IsUrl;TP;TP;0.95;729;358;1087;10000
84;daikon.inv.unary.string.IsUrl;TP;TP;0.95;744;397;1141;10000
85;daikon.inv.unary.string.IsUrl;TP;TP;0.95;769;380;1149;10000
86;daikon.inv.unary.string.IsUrl;TP;TP;0.95;784;378;1162;10000
87;daikon.inv.unary.string.IsUrl;TP;TP;0.95;750;413;1163;10000
88;daikon.inv.unary.string.IsUrl;TP;TP;0.95;746;455;1201;10000
89;daikon.inv.unary.string.IsUrl;TP;TP;0.95;751;421;1172;10000
90;daikon.inv.unary.string.IsUrl;TP;TP;0.95;756;345;1101;10000
91;daikon.inv.unary.string.IsUrl;TP;TP;0.95;740;369;1109;10000
92;daikon.inv.unary.string.IsUrl;TP;TP;0.95;724;408;1132;10000
93;daikon.inv.unary.string.IsUrl;TP;TP;0.95;728;409;1137;10000
94;daikon.inv.unary.string.IsUrl;TP;TP;0.95;746;387;1133;10000
95;daikon.inv.unary.string.IsUrl;TP;TP;0.95;769;377;1146;10000
96;daikon.inv.unary.string.IsUrl;TP;TP;0.95;706;356;1062;10000
97;daikon.inv.unary.string.IsUrl;TP;TP;0.95;730;383;1113;10000
98;daikon.inv.unary.string.FixedLengthString;TP;TP;0.95;740;416;1156;10000
99;daikon.inv.unary.string.dates.IsTimestampYYYYMMHHThhmmssmm;TP;TP;0.95;766;361;1127;10000
100;daikon.inv.unary.string.FixedLengthString;TP;TP;0.95;734;369;1103;10000
101;daikon.inv.unary.string.dates.IsTimestampYYYYMMHHThhmmssmm;TP;TP;0.95;760;391;1151;10000
102;daikon.inv.unary.string.FixedLengthString;TP;TP;0.95;734;493;1227;10000
103;daikon.inv.unary.string.dates.IsTimestampYYYYMMHHThhmmssmm;TP;TP;0.95;760;456;1216;10000
104;daikon.inv.unary.string.IsUrl;TP;TP;0.9;720;419;1139;10000
105;daikon.inv.unary.string.FixedLengthString;TP;FP;0.7;743;401;1144;10000
106;daikon.inv.binary.twoString.StdString$SubString;FP;TP;0.95;737;466;1203;50
107;daikon.inv.binary.twoString.StdString$SubString;FP;TP;0.9;751;336;1087;50
108;daikon.inv.binary.twoString.StdString$SubString;FP;TP;0.95;742;436;1178;50
109;daikon.inv.binary.twoString.StdString$SubString;TP;TP;0.95;750;344;1094;10000
110;daikon.inv.binary.twoString.StdString$SubString;TP;TP;0.99;797;367;1164;10000
111;daikon.inv.binary.twoString.StdString$SubString;TP;TP;0.95;816;427;1243;10000
112;daikon.inv.binary.twoString.StdString$SubString;TP;TP;0.95;783;420;1203;10000
113;daikon.inv.binary.twoString.StdString$SubString;TP;TP;0.95;790;344;1134;10000
114;daikon.inv.binary.twoString.StdString$SubString;TP;TP;0.95;845;417;1262;10000
115;daikon.inv.binary.twoString.StdString$SubString;TP;TP;0.95;859;352;1211;10000
116;daikon.inv.binary.twoString.StdString$SubString;TP;TP;0.95;858;392;1250;10000
117;daikon.inv.binary.twoString.StdString$SubString;TP;TP;0.95;869;417;1286;10000
118;daikon.inv.binary.twoString.StdString$SubString;TP;TP;0.95;843;378;1221;10000
119;daikon.inv.binary.twoString.StdString$SubString;TP;TP;0.95;835;355;1190;10000
120;daikon.inv.binary.twoString.StdString$SubString;TP;TP;0.95;833;457;1290;10000
121;daikon.inv.binary.twoString.StdString$SubString;TP;TP;0.95;816;391;1207;10000
122;daikon.inv.binary.twoString.StdString$SubString;TP;TP;0.95;850;419;1269;10000
123;daikon.inv.binary.twoString.StdString$SubString;TP;TP;0.95;772;354;1126;10000
124;daikon.inv.binary.twoString.StdString$SubString;TP;TP;0.95;817;372;1189;10000
125;daikon.inv.binary.twoString.StdString$SubString;TP;TP;0.95;873;385;1258;10000
126;daikon.inv.binary.twoString.StdString$SubString;TP;TP;0.95;887;372;1259;10000
127;daikon.inv.binary.twoString.StdString$SubString;TP;TP;0.95;859;415;1274;10000
128;daikon.inv.binary.twoString.StdString$SubString;TP;TP;0.95;853;432;1285;10000
129;daikon.inv.binary.twoString.StdString$SubString;TP;TP;0.95;867;451;1318;10000
130;daikon.inv.binary.twoString.StdString$SubString;TP;TP;0.95;851;364;1215;10000
131;daikon.inv.binary.twoString.StdString$SubString;TP;TP;0.95;883;400;1283;10000
132;daikon.inv.binary.twoString.StdString$SubString;TP;TP;0.95;903;397;1300;10000
133;daikon.inv.binary.twoString.StdString$SubString;TP;TP;0.95;865;392;1257;10000
134;daikon.inv.binary.twoString.StdString$SubString;TP;TP;0.95;843;397;1240;10000
135;daikon.inv.binary.twoString.StdString$SubString;TP;TP;0.95;853;348;1201;10000
136;daikon.inv.binary.twoString.StdString$SubString;TP;TP;0.95;849;399;1248;10000
137;daikon.inv.binary.twoString.StdString$SubString;TP;TP;0.95;845;357;1202;10000
138;daikon.inv.binary.twoString.StdString$SubString;TP;TP;0.95;843;370;1213;10000
139;daikon.inv.binary.twoString.StdString$SubString;TP;TP;0.95;895;389;1284;10000
140;daikon.inv.binary.twoString.StdString$SubString;TP;TP;0.95;860;384;1244;10000
141;daikon.inv.binary.twoString.StdString$SubString;TP;TP;0.95;862;413;1275;10000
142;daikon.inv.binary.twoString.StdString$SubString;TP;TP;0.95;868;361;1229;10000
143;daikon.inv.binary.twoString.StdString$SubString;TP;TP;0.95;880;422;1302;10000
144;daikon.inv.binary.twoString.StdString$SubString;TP;TP;0.95;865;356;1221;10000
145;daikon.inv.binary.twoString.StdString$SubString;TP;TP;0.95;875;401;1276;10000
146;daikon.inv.binary.twoString.StdString$SubString;TP;TP;0.95;849;413;1262;10000
147;daikon.inv.binary.twoString.StdString$SubString;TP;TP;0.95;843;336;1179;10000
148;daikon.inv.binary.twoString.StdString$SubString;TP;TP;0.95;863;400;1263;10000
149;daikon.inv.binary.twoString.StdString$SubString;TP;TP;0.95;871;415;1286;10000
150;daikon.inv.binary.twoString.StdString$SubString;TP;TP;0.95;887;411;1298;10000
151;daikon.inv.binary.twoString.StdString$SubString;TP;TP;0.95;857;389;1246;10000
152;daikon.inv.binary.twoString.StdString$SubString;TP;TP;0.95;857;423;1280;10000
153;daikon.inv.binary.twoString.StdString$SubString;TP;TP;0.95;853;380;1233;10000
154;daikon.inv.binary.twoString.StdString$SubString;TP;TP;0.95;885;376;1261;10000
155;daikon.inv.binary.twoString.StdString$SubString;TP;TP;0.95;853;364;1217;10000
156;daikon.inv.binary.twoString.StdString$SubString;TP;TP;0.95;849;330;1179;10000
157;daikon.inv.binary.twoString.StdString$SubString;TP;TP;0.99;847;411;1258;10000
158;daikon.inv.binary.twoString.StdString$SubString;TP;TP;0.95;863;406;1269;10000
159;daikon.inv.binary.twoString.StdString$SubString;TP;TP;0.95;863;409;1272;10000
160;daikon.inv.binary.twoString.StdString$SubString;TP;TP;0.95;829;417;1246;10000
161;daikon.inv.binary.twoString.StdString$SubString;TP;TP;0.95;797;403;1200;10000
162;daikon.inv.binary.twoString.StdString$SubString;TP;TP;0.95;757;402;1159;10000
163;daikon.inv.binary.twoString.StdString$SubString;TP;TP;0.95;767;392;1159;10000
164;daikon.inv.binary.twoString.StdString$SubString;TP;TP;0.95;775;416;1191;10000
165;daikon.inv.binary.twoScalar.IntEqual;FP;FP;0.7;667;374;1041;10000
166;daikon.inv.unary.string.OneOfString;FP;FP;0.9;679;446;1125;500
167;daikon.inv.binary.twoScalar.IntNonEqual;FP;TP;0.95;718;467;1185;10000
168;daikon.inv.binary.twoString.StdString$SubString;FP;TP;0.95;759;399;1158;10000
169;daikon.inv.binary.twoString.StdString$SubString;FP;FP;0.6;689;550;1239;1000
170;daikon.inv.binary.twoString.StdString$SubString;TP;FP;0.8;778;447;1225;10000
171;daikon.inv.unary.string.OneOfString;FP;FP;0.9;714;392;1106;1000
172;daikon.inv.unary.string.IsUrl;TP;TP;0.95;707;406;1113;10000
