ID;invariantType;classification;GPT_verdict;promptTokens;completionTokens;totalTokens
0;daikon.inv.binary.twoString.StringEqual;FP;TP;409;224;633
1;daikon.inv.binary.twoScalar.IntEqual;FP;FP;394;202;596
2;daikon.inv.binary.twoString.StringEqual;FP;FP;394;212;606
3;daikon.inv.binary.twoScalar.IntEqual;TP;FP;384;218;602
4;daikon.inv.binary.twoScalar.IntEqual;TP;FP;383;200;583
5;daikon.inv.binary.twoScalar.IntEqual;TP;FP;387;181;568
6;daikon.inv.binary.twoScalar.IntEqual;TP;FP;386;222;608
7;daikon.inv.binary.twoScalar.IntEqual;FP;FP;387;84;471
8;daikon.inv.binary.twoScalar.IntEqual;FP;FP;389;217;606
9;daikon.inv.binary.twoScalar.IntEqual;FP;FP;389;117;506
10;daikon.inv.unary.scalar.NonZero;TP;FP;376;173;549
11;daikon.inv.unary.string.OneOfString;TP;FP;438;196;634
12;daikon.inv.unary.string.OneOfString;TP;FP;418;201;619
13;daikon.inv.unary.scalar.LowerBound;TP;TP;369;199;568
14;daikon.inv.unary.scalar.LowerBound;TP;TP;372;216;588
15;daikon.inv.unary.scalar.LowerBound;TP;TP;366;164;530
16;daikon.inv.unary.scalar.LowerBound;TP;TP;370;198;568
17;daikon.inv.unary.scalar.NonZero;TP;TP;379;206;585
18;daikon.inv.unary.scalar.OneOfScalar;FP;FP;394;179;573
19;daikon.inv.unary.string.OneOfString;TP;FP;402;206;608
20;daikon.inv.unary.scalar.NonZero;TP;TP;370;159;529
21;daikon.inv.unary.scalar.OneOfScalar;TP;TP;406;99;505
22;daikon.inv.binary.twoScalar.IntLessThan;FP;FP;406;111;517
23;daikon.inv.binary.twoScalar.IntLessThan;FP;FP;407;123;530
24;daikon.inv.binary.twoScalar.IntNonEqual;FP;FP;401;201;602
25;daikon.inv.binary.twoScalar.IntGreaterThan;FP;FP;408;112;520
26;daikon.inv.binary.twoScalar.IntLessThan;FP;FP;404;275;679
27;daikon.inv.binary.twoScalar.IntLessThan;FP;FP;405;262;667
28;daikon.inv.binary.twoScalar.IntNonEqual;FP;FP;373;82;455
29;daikon.inv.binary.twoScalar.IntGreaterThan;FP;FP;385;223;608
30;daikon.inv.binary.twoScalar.IntGreaterThan;FP;FP;388;186;574
31;daikon.inv.binary.twoScalar.IntNonEqual;FP;FP;383;131;514
32;daikon.inv.binary.twoScalar.IntGreaterThan;FP;FP;386;189;575
33;daikon.inv.binary.twoScalar.IntGreaterThan;FP;TP;393;93;486
34;daikon.inv.binary.twoScalar.IntGreaterThan;FP;FP;386;34;420
35;daikon.inv.binary.twoScalar.IntNonEqual;FP;FP;390;167;557
36;daikon.inv.binary.twoScalar.IntNonEqual;FP;FP;384;206;590
37;daikon.inv.binary.twoScalar.IntGreaterThan;FP;FP;387;206;593
38;daikon.inv.binary.twoScalar.IntGreaterThan;FP;FP;394;81;475
39;daikon.inv.binary.twoScalar.IntGreaterEqual;FP;FP;386;204;590
40;daikon.inv.unary.scalar.NonZero;TP;FP;373;199;572
41;daikon.inv.unary.sequence.EltNonZero;TP;FP;383;107;490
42;daikon.inv.binary.twoScalar.IntGreaterEqual;TP;FP;403;136;539
43;daikon.inv.binary.twoScalar.IntNonEqual;FP;FP;401;239;640
44;daikon.inv.binary.twoScalar.IntNonEqual;FP;FP;403;138;541
45;daikon.inv.unary.string.IsUrl;TP;FP;401;185;586
46;daikon.inv.unary.string.FixedLengthString;TP;FP;414;235;649
47;daikon.inv.unary.string.IsUrl;TP;TP;383;191;574
48;daikon.inv.unary.string.IsUrl;TP;FP;383;196;579
49;daikon.inv.unary.string.IsUrl;TP;FP;402;217;619
50;daikon.inv.unary.string.IsUrl;TP;FP;405;206;611
51;daikon.inv.unary.string.IsUrl;TP;FP;405;197;602
52;daikon.inv.unary.string.IsUrl;TP;FP;406;204;610
53;daikon.inv.unary.string.IsUrl;TP;FP;400;187;587
54;daikon.inv.unary.string.IsUrl;TP;TP;401;217;618
55;daikon.inv.unary.string.IsUrl;TP;FP;400;222;622
56;daikon.inv.unary.string.IsUrl;TP;FP;386;151;537
57;daikon.inv.unary.string.IsUrl;TP;FP;404;218;622
58;daikon.inv.unary.string.FixedLengthString;TP;FP;393;198;591
59;daikon.inv.unary.string.IsUrl;TP;TP;382;170;552
60;daikon.inv.unary.string.IsUrl;TP;FP;382;171;553
61;daikon.inv.unary.string.IsUrl;TP;FP;390;184;574
62;daikon.inv.unary.string.IsUrl;TP;FP;391;198;589
63;daikon.inv.unary.string.IsUrl;TP;FP;390;191;581
64;daikon.inv.unary.string.IsUrl;TP;TP;389;198;587
65;daikon.inv.unary.string.IsUrl;TP;TP;394;140;534
66;daikon.inv.unary.string.IsUrl;TP;FP;387;189;576
67;daikon.inv.unary.string.IsUrl;TP;FP;390;229;619
68;daikon.inv.unary.string.IsUrl;TP;FP;392;191;583
69;daikon.inv.unary.string.IsUrl;TP;FP;389;186;575
70;daikon.inv.unary.string.IsUrl;TP;FP;388;197;585
71;daikon.inv.unary.string.IsUrl;TP;FP;388;184;572
72;daikon.inv.unary.string.IsUrl;TP;FP;386;164;550
73;daikon.inv.unary.string.IsUrl;TP;FP;385;181;566
74;daikon.inv.unary.string.IsUrl;TP;FP;387;190;577
75;daikon.inv.unary.string.IsUrl;TP;TP;394;155;549
76;daikon.inv.unary.string.IsUrl;TP;FP;391;211;602
77;daikon.inv.unary.string.IsUrl;TP;FP;390;231;621
78;daikon.inv.unary.string.IsUrl;TP;FP;390;199;589
79;daikon.inv.unary.string.IsUrl;TP;FP;390;234;624
80;daikon.inv.unary.string.IsUrl;TP;FP;388;178;566
81;daikon.inv.unary.string.IsUrl;TP;FP;389;197;586
82;daikon.inv.unary.string.IsUrl;TP;TP;388;142;530
83;daikon.inv.unary.string.IsUrl;TP;FP;386;181;567
84;daikon.inv.unary.string.IsUrl;TP;FP;389;211;600
85;daikon.inv.unary.string.IsUrl;TP;TP;391;201;592
86;daikon.inv.unary.string.IsUrl;TP;FP;395;170;565
87;daikon.inv.unary.string.IsUrl;TP;FP;389;187;576
88;daikon.inv.unary.string.IsUrl;TP;FP;388;209;597
89;daikon.inv.unary.string.IsUrl;TP;FP;391;180;571
90;daikon.inv.unary.string.IsUrl;TP;FP;389;174;563
91;daikon.inv.unary.string.IsUrl;TP;FP;387;192;579
92;daikon.inv.unary.string.IsUrl;TP;FP;386;182;568
93;daikon.inv.unary.string.IsUrl;TP;FP;385;196;581
94;daikon.inv.unary.string.IsUrl;TP;FP;387;209;596
95;daikon.inv.unary.string.IsUrl;TP;FP;390;199;589
96;daikon.inv.unary.string.IsUrl;TP;FP;367;166;533
97;daikon.inv.unary.string.IsUrl;TP;TP;386;199;585
98;daikon.inv.unary.string.FixedLengthString;TP;FP;391;223;614
99;daikon.inv.unary.string.dates.IsTimestampYYYYMMHHThhmmssmm;TP;FP;417;249;666
100;daikon.inv.unary.string.FixedLengthString;TP;FP;390;209;599
101;daikon.inv.unary.string.dates.IsTimestampYYYYMMHHThhmmssmm;TP;FP;416;190;606
102;daikon.inv.unary.string.FixedLengthString;TP;FP;390;177;567
103;daikon.inv.unary.string.dates.IsTimestampYYYYMMHHThhmmssmm;TP;TP;416;90;506
104;daikon.inv.unary.string.IsUrl;TP;FP;384;178;562
105;daikon.inv.unary.string.FixedLengthString;TP;FP;398;168;566
106;daikon.inv.binary.twoString.StdString$SubString;FP;FP;405;258;663
107;daikon.inv.binary.twoString.StdString$SubString;FP;FP;410;165;575
108;daikon.inv.binary.twoString.StdString$SubString;FP;FP;410;210;620
109;daikon.inv.binary.twoString.StdString$SubString;TP;FP;402;174;576
110;daikon.inv.binary.twoString.StdString$SubString;TP;FP;412;195;607
111;daikon.inv.binary.twoString.StdString$SubString;TP;FP;412;196;608
112;daikon.inv.binary.twoString.StdString$SubString;TP;FP;397;239;636
113;daikon.inv.binary.twoString.StdString$SubString;TP;FP;398;210;608
114;daikon.inv.binary.twoString.StdString$SubString;TP;FP;437;99;536
115;daikon.inv.binary.twoString.StdString$SubString;TP;FP;440;210;650
116;daikon.inv.binary.twoString.StdString$SubString;TP;FP;440;228;668
117;daikon.inv.binary.twoString.StdString$SubString;TP;FP;441;228;669
118;daikon.inv.binary.twoString.StdString$SubString;TP;FP;435;94;529
119;daikon.inv.binary.twoString.StdString$SubString;TP;FP;436;226;662
120;daikon.inv.binary.twoString.StdString$SubString;TP;FP;435;161;596
121;daikon.inv.binary.twoString.StdString$SubString;TP;FP;421;181;602
122;daikon.inv.binary.twoString.StdString$SubString;TP;FP;439;244;683
123;daikon.inv.binary.twoString.StdString$SubString;TP;FP;390;160;550
124;daikon.inv.binary.twoString.StdString$SubString;TP;FP;401;197;598
125;daikon.inv.binary.twoString.StdString$SubString;TP;FP;424;164;588
126;daikon.inv.binary.twoString.StdString$SubString;TP;TP;425;197;622
127;daikon.inv.binary.twoString.StdString$SubString;TP;FP;424;200;624
128;daikon.inv.binary.twoString.StdString$SubString;TP;FP;423;239;662
129;daikon.inv.binary.twoString.StdString$SubString;TP;FP;428;195;623
130;daikon.inv.binary.twoString.StdString$SubString;TP;FP;421;166;587
131;daikon.inv.binary.twoString.StdString$SubString;TP;FP;424;203;627
132;daikon.inv.binary.twoString.StdString$SubString;TP;FP;426;231;657
133;daikon.inv.binary.twoString.StdString$SubString;TP;FP;423;181;604
134;daikon.inv.binary.twoString.StdString$SubString;TP;FP;422;234;656
135;daikon.inv.binary.twoString.StdString$SubString;TP;FP;422;195;617
136;daikon.inv.binary.twoString.StdString$SubString;TP;FP;420;176;596
137;daikon.inv.binary.twoString.StdString$SubString;TP;FP;419;170;589
138;daikon.inv.binary.twoString.StdString$SubString;TP;FP;421;163;584
139;daikon.inv.binary.twoString.StdString$SubString;TP;FP;428;210;638
140;daikon.inv.binary.twoString.StdString$SubString;TP;FP;425;189;614
141;daikon.inv.binary.twoString.StdString$SubString;TP;FP;424;176;600
142;daikon.inv.binary.twoString.StdString$SubString;TP;FP;424;121;545
143;daikon.inv.binary.twoString.StdString$SubString;TP;FP;424;119;543
144;daikon.inv.binary.twoString.StdString$SubString;TP;FP;422;174;596
145;daikon.inv.binary.twoString.StdString$SubString;TP;FP;423;167;590
146;daikon.inv.binary.twoString.StdString$SubString;TP;FP;422;180;602
147;daikon.inv.binary.twoString.StdString$SubString;TP;FP;420;158;578
148;daikon.inv.binary.twoString.StdString$SubString;TP;FP;423;205;628
149;daikon.inv.binary.twoString.StdString$SubString;TP;FP;425;168;593
150;daikon.inv.binary.twoString.StdString$SubString;TP;FP;429;171;600
151;daikon.inv.binary.twoString.StdString$SubString;TP;FP;423;168;591
152;daikon.inv.binary.twoString.StdString$SubString;TP;FP;422;168;590
153;daikon.inv.binary.twoString.StdString$SubString;TP;FP;425;192;617
154;daikon.inv.binary.twoString.StdString$SubString;TP;FP;423;182;605
155;daikon.inv.binary.twoString.StdString$SubString;TP;FP;421;199;620
156;daikon.inv.binary.twoString.StdString$SubString;TP;FP;420;171;591
157;daikon.inv.binary.twoString.StdString$SubString;TP;FP;419;174;593
158;daikon.inv.binary.twoString.StdString$SubString;TP;FP;421;160;581
159;daikon.inv.binary.twoString.StdString$SubString;TP;FP;424;191;615
160;daikon.inv.binary.twoString.StdString$SubString;TP;FP;420;189;609
161;daikon.inv.binary.twoString.StdString$SubString;TP;FP;414;192;606
162;daikon.inv.binary.twoString.StdString$SubString;TP;FP;420;221;641
163;daikon.inv.binary.twoString.StdString$SubString;TP;FP;425;214;639
164;daikon.inv.binary.twoString.StdString$SubString;TP;FP;425;165;590
165;daikon.inv.binary.twoScalar.IntEqual;FP;FP;389;168;557
166;daikon.inv.unary.string.OneOfString;FP;FP;410;215;625
167;daikon.inv.binary.twoScalar.IntNonEqual;FP;FP;387;170;557
168;daikon.inv.binary.twoString.StdString$SubString;FP;FP;395;288;683
169;daikon.inv.binary.twoString.StdString$SubString;FP;FP;392;194;586
170;daikon.inv.binary.twoString.StdString$SubString;TP;FP;410;223;633
171;daikon.inv.unary.string.OneOfString;FP;FP;428;113;541
172;daikon.inv.unary.string.IsUrl;TP;FP;368;172;540
